11111111
1P00C000
10000001
1C000CC1
1111E111
11111111