11111111
1P00C001
10000001
1C000CC1
1111E11
11111111