11111111111111111111111111111111111
1P011101C1CC11101C1E11C00111C000E11
10011000000111000000011000000111111
110C100000C1C00001000111000111CCC11
11000C00011111100000011001111101011
1000000100110C1C0000000011110000011
1C0100CC000000000000011000000111111
11111111111111111111111111111111111