111111111
1P00C0E01
100000001
111111111