11111111
1P000001
10000001
10000001
1111E111
11111111