11111111
1P00C001
10000021
1C000CC1
1111E111
11111111