11111111
10000001
10000001
10C00001
1111E111
11111111